0 0 0 0 4 5 0 0 0 0 
0 0 0 35 36 37 38 0 0 0
0 0 0 67 68 69 70 0 0 0
0 0 0 99 100 101 102 0 0 0
0 0 0 131 132 133 134 0 0 0
0 0 0 163 164 165 166 0 0 0
0 0 0 195 196 197 198 0 0 0
0 0 0 0 0 0 0 0 0 0
0 0 0 0 0 0 601 602 602 602
0 0 0 0 0 0 633 0 0 0